5555555555555555555555555555
5221444444444004444444441225
5221444444444004444444441225
5111000011100000011100001115
5444401111111001111111044445
5444411155551111555511144445
5444411156665555777511144445
5444401156666677777511044445
5444400115666677775110044445
5444400011566677751100044445
5444400001156677511000044445
5444400000115675110000044445
5444400000011551100000044445
5444401111110110111111044445
5444444444444444444444444445
5444444444444444444444444445
5000000000000550000000000005
5000000044444444444400000555
5000000554444444444550000005
5000000551111111111550000005
5000004410605005060144000005
5000004410005005000144000005
5000000551111111111550000005
5000000554444444444550000005
5111100044441111444400001115
5222100000001901000000001445
5222100000001001000000001475
5555555555555555555555555555