5555555555555555555555555555
5610000000000000000000000165
5110000000000000000000000115
5000000000000000000000000005
5000000444444444444440000005
5000000444411111144440000005
5000000444414744144440000005
5000055555511111155555500005
5000050000511111150000500005
5000000000000000000000000005
5044000000000000000000004405
5544000000122552210000004455
5544000000155905510000004455
5544000000111001110000004455
5544000000151111510000004455
5544000000000000000000004455
5044000000000000000000004405
5044000000000000000000004405
5111000000000000000000001115
5221005000511111150005001225
5221005555511111155555001225
5221000444444444444440001225
5221000444444444444440001225
5221000444444444444440001225
5221000000000000000000001225
5221000000000000000000001225
5221000000000000000000001225
5555555555555555555555555555