5555555555555555555555555555
5710000004444004444000000165
5110000004444004444000000115
5440000055555005500555000445
5440000055555005505500000445
5440000000055005555000000445
5440000000055005555000000445
5440000055555005505500000445
5440000055555005500550000445
5440000000055005500055000445
5440000000055005500005500445
5440000055555000000000000445
5440000000000000000000000445
5000000000000000000000000005
5000000000000000000000000005
5550000000000550000000000555
5550000000005555000000000555
5220000000011111100000000225
5221100000011171100000011225
5221155111511111151115511225
5221155111511111151115511225
5221100000000000000110011225
5221100000000000000110011225
5221100000000000000000011225
5221000000001111000000001225
5221000000005905000000001225
5221000000005005000000001225
5555555555555555555555555555